
C 255 ,         0    , +255
	F 255 ,         0    , +255
NO ./fake

WE ./fake

EA no se

SO jsdkfj



1111
1N01
 110
 11
