
C 255 ,         0    , +255
	F 255 ,         0    , +255
NO ./fake

WE ./fake

EA no se

SO jsdkfj



11111111
10000001
1100N001
11000001
11111111
