
C 255 ,         0    , +255
	F 255 ,         0    , +255
NO ./fake

WE ./fake

EA no se

SO jsdkfj



111111
1N0001
110001
111111
