
C 0, 0, 51
F 44, 92, 36

EA ./assets/textures/BrickOv.xpm
NO ./assets/textures/BrickOv.xpm
SO ./assets/textures/BrickOv.xpm
WE ./assets/textures/BrickOv.xpm

DO ./assets/textures/door_sample.xpm

11111111111111111111111111111111111111
10010100111111111111111111110111111111
10000100011111111111111111100011111111
10000100111111111111111111100011111111
10000001111111111111111111110111111111
1100N000111111111111111111110111111111
10000000111111111111111111110111111111
1001110011111111111111111111D111111111
11111110111111111111111111100011111111
11111110111111111111111111100011111111
1111111D111111111111111111100011111111
11111110000001111111111111100011111111
11111100000011111111111111100011111111
11111100000011111111111111100011111111
11111100000011111111111111100011111111
11111100000011111111111111100011111111
11111100000011111111111111100011111111
11111100000011111111111111100011111111
11111100000011111111111110000000011111
11111110011111111111111110000000011111
1111100000000000000D000000000000011111
11110000000000011111111110000000011111
11111111111111111111111111111111111111
