
C 0, 0, 0
F 0, 255, 0

EA ./assets/textures/east_sample.xpm
NO ./assets/textures/north_sample.xpm
SO ./assets/textures/south_sample.xpm
WE ./assets/textures/west_sample.xpm

DO ./assets/textures/door_sample.xpm

1111111111111111111111111111111111111
1001010011111111111111111111011111111
1000010001111111111111111110001111111
1000010011111111111111111110001111111
1000000111111111111111111111011111111
1100N00011111111111111111111011111111
1000000011111111111111111111011111111
1001110011111111111111111111D11111111
11111110111111111111111111100011111111
11111110111111111111111111100011111111
1111111D111111111111111111100011111111
11111110000001111111111111100011111111
11111100000011111111111111100011111111
11111100000011111111111111100011111111
11111100000011111111111111100011111111
11111100000011111111111111100011111111
11111100000011111111111111100011111111
11111100000011111111111111100011111111
1111110000001111111111111000000001111
1111111001111111111111111000000001111
1111100000000000000D00000000000001111
1111000000000001111111111000000001111
1111111111111111111111111111111111111
