
C 199, 37, 217
F 105, 50, 112

EA ./assets/textures/east_sample.xpm
NO ./assets/textures/north_sample.xpm
SO ./assets/textures/south_sample.xpm
WE ./assets/textures/west_sample.xpm

111111111
100101001
1000010001
100001001
100000011
1100N0001
100000001
100111001
111111111
