
C 199, 37, 217
F 105, 50, 112

NO ../textures/TODO
WE ../textures/TODO
EA ../textures/TODO
SO ../textures/TODO

 1111111
100101001
100000001
100000001
1000W0011
110000001
100000001
100111001
 1111111

