
C 199, 37, 217
F 105, 50, 112

EA ./assets/textures/east_sample.xpm
NO ./assets/textures/north_sample.xpm
SO ./assets/textures/south_sample.xpm
WE ./assets/textures/west_sample.xpm

1111111111111111111
1001010011111111111
10000100011111111111
10000100111111111111
10000001111111111111
1100N000111111111111
10000000111111111111
10011100111111111111
11111110111111111111
11111110111111111111
11111110111111111111
11111110000001111111
11111100000011111111
1111111111111111111

