DO ./assets/textures/door.xpm

C 173, 216, 230
F 105, 105, 105

EA ./assets/textures/angel.xpm
NO ./assets/textures/colom.xpm
SO ./assets/textures/cool.xpm
WE ./assets/textures/daniel.xpm

1111111111111111111
1001010011111111111
10000100011111111111
10000100111111111111
10000001111111111111
1100N000111111111111
10000000111111111111
10011100111111111111
1111111D111111111111
11111110111111111111
11111110111111111111
11111110000001111111
11111100000011111111
1111111111111111111

