NO ./assets/textures/sample/north.xpm
SO ./assets/textures/sample/south.xpm
WE ./assets/textures/sample/west.xpm
EA ./assets/textures/sample/east.xpm
DO ./assets/textures/sample/door.xpm
F 3,197,72
C 24,25,90
        1111111111111111111111111
        1000000000110000000000001
        1011000001110000000000001
        1001000000000000000000001
111111111011000001110000000000001
10000000001100000111011111D111111
11110111111111011100000010001
11110111111111011101010010001
11000000110101011100000010001
10000000000000001100000010001
100000000000000011010100D0001
110000011101D1011111011110N0111
11110111 1110101 101111010001
11111111 1111111 111111111111
